20
100
45 0 0 0 0 0 0 0 0 0 0 0 0 0 0 0 0 0 0 43 
45 0 0 0 0 0 0 0 0 0 0 0 0 0 0 0 0 0 0 43 
45 0 0 0 0 0 0 0 0 0 0 0 0 0 0 0 0 0 0 43 
45 0 0 0 0 0 0 0 44 44 44 44 0 0 0 0 0 0 0 43 
45 0 0 0 0 0 0 0 0 44 44 0 0 0 0 0 0 0 0 43 
45 0 0 0 0 0 0 0 0 0 0 0 0 0 0 0 0 0 0 43 
45 0 0 0 0 0 0 0 0 0 0 0 0 0 0 0 0 0 0 18 
45 0 0 0 0 0 0 0 0 0 0 0 0 0 0 0 0 0 0 43 
45 0 0 0 0 0 0 0 0 0 0 0 0 0 0 0 0 0 0 43 
45 0 0 0 0 0 0 0 0 0 0 0 0 0 0 0 0 0 0 43 
45 0 0 0 0 0 0 0 0 0 0 0 0 0 0 0 0 0 0 43 
45 0 0 0 0 0 0 0 0 0 0 0 0 0 0 0 0 0 0 43 
45 0 0 0 0 0 0 0 0 0 0 0 0 0 0 0 0 0 0 18 
45 0 0 0 0 0 0 0 0 0 0 0 0 0 0 0 0 0 0 43 
45 0 0 0 0 0 0 0 0 0 0 0 0 0 0 0 0 0 0 43 
45 0 0 0 0 0 0 0 0 0 0 0 0 0 0 0 0 0 0 43 
45 0 0 0 0 0 0 0 0 0 0 0 0 0 0 0 0 0 0 43 
45 0 0 0 0 0 0 0 0 0 0 0 0 0 0 0 0 0 0 43 
45 0 0 0 0 0 0 0 0 0 0 0 0 0 0 0 0 0 0 43 
45 0 0 0 0 0 0 0 0 0 0 0 0 0 0 0 0 0 0 43 
18 0 0 0 0 0 0 0 0 0 0 0 0 0 0 0 0 0 0 43 
45 0 0 0 0 0 0 0 0 0 0 0 0 0 0 0 0 0 0 43 
45 0 0 0 0 0 0 0 0 0 0 0 0 0 0 0 0 0 0 43 
45 0 0 0 0 0 0 0 0 0 0 0 0 0 0 0 0 0 0 43 
45 0 0 0 0 0 0 0 0 0 0 0 0 0 0 0 0 0 0 43 
45 0 0 0 0 0 0 0 0 0 0 0 0 0 0 0 0 0 0 43 
45 0 0 0 0 0 0 0 0 0 0 0 0 0 0 0 0 0 0 18 
45 0 0 0 0 0 0 0 0 0 0 0 0 0 0 0 0 0 0 43 
45 0 0 0 0 0 0 0 0 0 0 0 0 0 0 0 0 0 0 43 
45 0 0 0 0 8 0 0 0 0 0 0 0 0 0 0 0 9 10 44 
45 0 0 0 0 0 0 0 0 0 0 0 0 0 0 0 0 0 0 43 
45 0 0 0 0 0 0 0 0 0 0 0 0 0 0 0 0 0 0 43 
45 0 0 0 0 0 0 0 0 0 0 0 0 0 0 0 0 0 0 43 
45 0 0 0 0 0 0 0 0 0 0 0 0 0 0 0 0 0 0 43 
18 0 0 0 0 0 0 0 0 0 0 0 0 0 0 0 0 0 0 43 
45 0 0 0 0 0 0 0 0 0 0 0 0 0 0 0 0 0 0 43 
45 0 0 0 0 8 0 0 0 0 0 0 0 0 0 0 0 0 0 43 
45 0 0 0 0 0 0 0 0 0 0 0 8 0 0 0 0 0 0 43 
45 0 0 0 0 0 0 0 0 0 0 0 0 0 0 0 0 0 0 43 
45 0 0 0 0 0 0 0 0 0 0 0 0 0 0 0 0 0 0 43 
45 0 0 0 0 0 0 0 0 0 0 0 0 0 0 0 0 0 0 18 
45 0 0 0 0 0 0 0 0 0 0 0 0 0 0 0 0 0 0 43 
45 0 0 0 0 0 0 0 0 0 0 0 0 0 0 0 0 0 0 43 
45 0 0 0 0 0 0 0 0 0 0 38 0 0 0 0 0 0 0 43 
45 0 0 0 0 0 0 0 0 0 0 45 0 0 0 0 0 0 0 43 
45 0 0 0 0 0 0 0 0 0 0 18 0 0 0 0 0 0 0 43 
45 0 0 0 0 9 11 0 0 0 0 52 0 0 0 0 0 0 0 43 
45 0 0 0 0 0 0 0 0 0 0 0 0 0 0 0 0 0 0 43 
45 0 0 0 0 0 0 0 0 0 0 0 0 0 0 0 0 0 0 43 
45 0 0 0 0 0 0 0 0 0 0 0 0 0 0 0 0 0 0 43 
45 0 0 0 0 0 0 0 0 0 0 0 0 0 0 0 0 0 0 43 
18 0 0 0 0 0 0 0 0 0 0 0 0 0 0 0 0 0 0 43 
45 0 0 0 0 0 0 0 0 0 0 0 0 0 0 0 0 0 0 43 
45 0 0 0 0 0 0 0 0 0 0 0 0 0 0 0 0 0 0 43 
45 0 0 0 0 0 0 0 0 0 0 0 0 0 0 0 0 0 0 43 
45 0 0 0 0 0 0 0 0 0 0 0 0 0 0 0 0 0 0 43 
45 0 0 0 0 0 0 0 0 0 0 0 0 0 0 0 0 0 0 43 
45 0 0 0 0 0 0 0 0 0 0 0 0 0 0 0 0 0 0 18 
45 0 0 0 0 0 0 0 0 0 0 0 0 0 0 0 0 0 0 43 
45 0 0 0 0 0 0 0 0 0 0 0 0 0 0 0 0 0 0 43 
45 0 0 0 0 0 0 0 0 0 0 0 0 0 0 0 0 0 0 43 
45 0 0 0 0 38 0 0 0 0 0 0 0 0 0 0 0 0 0 43 
45 0 0 0 0 45 0 0 0 0 0 0 0 0 0 0 0 0 0 43 
45 0 0 9 10 52 0 0 0 0 0 0 0 0 0 0 0 0 0 43 
18 0 0 0 0 0 0 0 0 0 0 0 0 0 36 0 0 0 0 43 
45 0 0 0 0 0 0 0 0 0 0 0 0 0 50 38 0 0 0 43 
45 0 0 9 11 0 0 0 0 0 0 0 0 0 0 43 0 0 0 43 
45 0 0 0 0 0 0 0 0 0 0 0 0 0 0 50 11 0 0 43 
45 0 0 0 0 0 0 0 0 0 0 0 0 0 0 0 0 0 0 43 
45 0 0 0 0 0 0 0 0 0 0 0 0 0 0 0 0 0 0 43 
45 0 0 0 0 0 0 0 0 0 0 0 0 0 0 0 0 0 0 43 
45 0 0 0 0 0 0 0 0 0 0 0 0 0 0 0 0 0 0 43 
45 0 0 0 0 0 0 0 0 0 0 0 0 0 0 0 0 0 0 18 
45 0 0 0 0 0 0 0 0 0 0 0 0 0 0 0 8 0 0 43 
45 0 0 0 0 0 0 0 0 0 0 0 0 0 0 0 0 0 0 43 
45 0 0 0 0 0 0 0 0 0 0 0 0 0 0 0 0 0 0 43 
45 0 0 0 0 0 0 0 0 0 0 0 0 0 0 0 0 0 0 43 
45 0 0 0 0 0 0 0 0 0 0 0 0 0 0 0 0 0 0 43 
45 0 0 0 0 0 0 0 0 0 0 0 0 0 0 0 0 0 0 43 
45 0 0 0 0 0 0 0 0 0 0 0 0 0 0 0 0 0 0 43 
45 0 0 0 0 0 0 0 0 0 0 0 0 0 0 0 0 0 0 43 
45 0 0 0 0 0 0 0 0 0 0 0 0 0 0 0 0 0 0 43 
45 0 0 0 0 0 0 0 0 0 0 0 0 0 0 0 0 0 0 43 
45 0 0 0 0 0 0 0 0 0 0 0 0 0 0 0 0 0 0 43 
45 37 37 37 37 37 37 18 0 0 0 0 18 37 37 37 37 37 37 43 
44 10 10 10 10 10 10 18 51 51 51 51 18 10 10 10 10 10 10 44 
45 0 0 0 0 0 0 0 0 0 0 0 0 0 0 0 0 0 0 43 
45 0 0 0 0 0 0 0 0 0 0 0 0 0 0 0 0 0 0 43 
45 0 0 0 0 0 0 0 0 0 0 0 0 0 0 0 0 0 0 43 
45 0 0 0 0 0 0 0 0 0 0 0 0 0 0 0 0 0 0 43 
45 0 0 0 0 0 0 0 0 36 38 0 0 0 0 0 0 0 0 43 
45 0 0 0 0 0 0 0 0 18 18 0 0 0 0 0 0 0 0 43 
45 0 0 0 0 0 0 0 0 50 52 0 0 0 0 0 0 0 0 43 
45 0 0 0 0 0 0 0 0 0 0 0 0 0 0 0 0 0 0 43 
45 0 0 0 0 0 0 0 0 0 0 0 0 0 0 0 0 0 0 43 
45 0 0 0 0 0 0 0 0 0 0 0 0 0 0 0 0 0 0 43 
45 0 0 0 0 0 0 0 0 0 0 0 0 0 0 0 0 0 0 43 
18 0 0 0 0 0 0 0 0 0 0 0 0 0 0 0 0 0 0 18 
45 0 0 0 0 0 0 0 0 0 0 0 0 0 0 0 0 0 0 43 
44 37 37 37 37 37 37 37 37 37 37 37 37 37 37 37 37 37 37 44