20
264
45 0 0 0 0 0 0 0 0 0 0 0 0 0 0 0 0 0 0 43 
45 0 0 0 0 0 0 0 0 0 0 0 0 0 0 0 0 0 0 43 
45 0 0 0 0 0 0 0 0 0 0 0 0 0 0 0 0 0 0 43 
44 10 10 11 0 0 0 0 0 0 0 0 0 0 0 0 0 0 0 43 
45 0 0 0 0 0 0 0 0 0 0 0 0 0 0 0 0 0 0 43 
45 0 0 0 0 0 0 0 0 0 0 0 0 0 0 0 0 0 0 43 
45 0 0 0 0 0 0 0 0 0 0 0 0 0 0 0 0 0 0 43 
45 0 0 0 0 0 0 0 0 0 0 0 0 0 0 0 0 0 0 43 
45 0 0 0 0 0 0 0 0 0 0 0 0 0 0 0 0 0 0 43 
45 0 0 0 0 0 0 0 0 0 0 0 0 0 0 0 0 0 0 43 
45 0 0 0 0 0 0 0 0 0 0 0 0 0 0 0 0 0 0 43 
45 0 0 0 0 0 0 0 0 0 0 0 0 0 0 0 0 0 0 18 
45 0 0 0 0 0 0 0 0 0 0 0 0 0 0 0 0 0 0 43 
45 0 0 0 0 0 0 0 0 0 0 0 0 0 0 0 0 0 0 43 
45 0 0 8 0 0 0 0 0 0 8 0 0 0 0 0 0 0 0 43 
45 0 0 0 0 0 0 0 0 0 0 0 0 0 0 0 0 0 0 43 
45 0 0 0 0 0 0 0 0 0 0 0 0 0 0 0 0 0 0 43 
45 0 0 0 0 0 0 0 0 0 0 0 0 0 0 0 0 0 0 43 
45 0 0 0 0 0 0 0 0 0 0 0 0 0 0 0 0 0 0 18 
45 0 0 0 0 0 0 0 0 0 0 0 8 0 0 0 0 0 0 43 
45 0 0 0 0 0 0 0 0 0 0 0 0 0 0 0 0 0 0 43 
45 0 0 0 0 0 0 0 0 0 0 0 0 0 0 0 0 0 0 43 
18 0 0 0 0 0 0 0 0 0 0 0 0 0 0 0 0 0 0 43 
45 0 0 0 0 0 0 0 0 0 0 0 0 0 0 0 0 0 0 43 
45 0 0 38 0 0 0 0 0 0 0 0 36 0 0 0 0 0 0 43 
45 0 9 52 0 0 0 0 0 0 0 0 43 0 36 11 0 0 0 43 
45 0 0 0 0 0 0 0 0 0 0 0 50 10 52 0 0 0 0 43 
45 0 0 0 0 0 0 0 0 0 0 0 0 0 0 0 0 0 0 43 
45 0 0 0 0 0 0 0 0 0 0 0 0 0 0 0 0 0 0 43 
45 0 0 0 0 0 0 0 0 0 0 0 0 0 0 0 0 0 0 43 
45 0 0 0 0 0 0 0 0 0 0 0 0 0 0 0 0 0 0 18 
45 0 0 0 0 0 0 0 0 0 0 0 0 0 0 0 0 0 0 43 
45 0 0 0 0 0 0 0 0 0 0 0 0 0 0 0 0 0 9 44 
45 0 0 0 0 0 0 0 0 0 0 0 0 0 0 0 0 0 0 43 
45 0 0 0 0 0 0 0 0 0 0 0 0 0 0 0 0 0 0 43 
45 0 0 0 0 0 0 0 0 0 0 0 0 0 0 0 0 0 0 43 
45 0 0 0 0 0 0 0 0 0 0 0 0 0 0 0 0 0 0 43 
45 0 0 0 0 0 0 0 0 0 0 0 0 0 0 0 0 0 0 43 
45 0 0 0 0 0 0 0 0 0 0 0 0 0 0 0 0 0 0 43 
45 0 0 0 0 0 0 0 0 0 0 0 0 0 0 0 0 0 0 43 
45 0 0 0 0 0 0 0 0 0 0 0 0 0 0 0 0 0 0 43 
45 0 0 0 0 0 0 0 0 0 0 0 0 0 0 0 0 0 0 43 
45 0 0 0 0 0 0 0 0 0 0 0 0 0 0 0 0 0 0 43 
18 0 0 0 0 0 0 0 0 0 0 0 0 0 0 0 0 0 0 43 
45 0 0 0 0 0 0 0 0 0 0 0 0 0 0 0 0 0 0 18 
45 0 0 0 0 0 0 0 0 0 0 0 0 0 0 0 0 0 0 43 
45 0 0 0 0 0 0 0 0 0 0 0 0 0 0 0 0 0 0 43 
45 0 0 0 0 0 0 0 0 0 0 0 0 0 0 0 0 0 0 43 
45 0 0 0 0 0 0 0 0 0 0 0 0 0 0 0 0 0 0 43 
45 0 0 0 0 0 0 0 0 0 0 0 0 0 0 0 0 0 0 43 
45 0 0 0 0 0 0 0 0 0 0 0 0 0 0 0 0 0 0 18 
45 0 0 0 0 0 0 0 0 0 0 0 0 0 0 0 0 0 36 44 
45 0 0 0 8 0 0 0 0 0 0 0 0 0 0 0 0 9 51 44 
45 0 0 0 0 0 0 0 0 0 0 0 0 0 0 0 0 0 0 43 
45 0 0 0 0 0 0 0 0 0 0 0 0 0 0 0 0 0 0 43 
45 0 0 0 0 0 0 0 0 0 0 0 0 0 0 0 0 0 0 43 
18 0 0 0 0 0 0 0 0 0 0 0 0 0 0 0 0 0 0 43 
44 11 0 0 0 0 0 0 0 0 0 0 0 0 0 0 0 0 0 43 
45 0 0 0 0 0 0 0 0 0 0 0 0 0 0 0 0 0 0 43 
45 0 0 0 0 0 0 0 0 0 0 0 0 0 0 0 0 0 0 43 
45 0 0 0 0 0 0 0 0 0 0 0 0 0 0 0 0 0 0 43 
45 0 0 0 0 0 0 0 0 0 0 0 0 0 0 0 0 0 0 18 
45 0 0 0 0 0 0 0 0 0 0 0 0 0 0 0 0 0 0 43 
45 0 0 0 0 0 0 0 0 0 0 0 0 0 0 0 0 0 0 43 
45 0 0 0 0 0 0 0 0 0 0 0 0 0 0 0 0 0 0 43 
18 0 0 0 0 0 0 0 0 0 0 0 0 0 0 0 0 0 0 43 
45 0 0 0 0 0 0 0 0 0 0 0 0 0 0 0 0 0 0 43 
45 0 0 0 0 0 0 0 0 0 0 0 0 0 0 0 0 0 0 43 
45 0 0 0 36 38 0 0 0 0 0 0 0 0 0 0 0 0 0 43 
45 0 0 0 0 50 11 0 0 0 0 0 0 0 0 0 0 0 0 43 
45 0 0 0 0 0 0 0 0 0 0 0 0 0 0 0 0 0 0 43 
45 0 0 0 0 0 0 0 0 0 0 0 0 0 0 0 0 0 0 43 
45 0 0 0 0 0 0 0 0 0 0 0 0 0 0 0 0 0 0 43 
45 0 0 0 0 0 0 0 0 0 0 0 0 0 0 0 0 0 0 43 
45 0 0 0 0 0 0 0 0 0 0 0 0 0 0 0 0 0 0 18 
45 0 0 0 0 0 0 0 0 0 0 0 0 0 0 0 0 0 0 43 
45 0 0 0 0 0 0 0 0 0 0 0 0 0 0 0 0 0 0 43 
45 0 0 0 0 0 0 0 0 0 0 0 0 0 0 0 0 0 0 43 
45 0 0 0 0 0 0 0 0 0 0 0 0 0 0 0 0 0 0 43 
45 0 0 0 0 0 0 0 0 0 0 0 0 0 0 0 0 0 0 43 
18 0 0 0 0 0 0 0 0 0 0 0 0 0 0 0 0 0 0 43 
45 0 0 0 0 0 0 0 0 0 0 0 0 0 0 0 0 0 0 43 
45 0 0 0 0 0 0 0 0 36 37 38 0 0 0 0 0 0 0 43 
45 0 0 0 0 0 0 0 9 51 51 51 11 0 0 0 0 0 0 43 
45 0 0 0 0 0 0 0 0 0 0 0 0 0 0 0 0 0 0 43 
45 0 0 0 0 0 0 0 0 0 0 0 0 0 0 0 0 0 0 18 
45 0 0 0 0 0 0 36 38 0 0 0 0 38 0 0 0 0 0 43 
45 0 0 0 0 0 0 50 0 0 0 0 0 52 0 0 0 0 0 43 
45 0 0 0 0 0 0 0 0 0 0 0 0 0 0 0 0 0 0 43 
45 0 0 0 0 0 0 0 0 0 0 0 0 0 0 0 0 0 0 43 
45 0 0 0 0 0 0 36 38 0 0 0 0 0 0 0 0 0 0 43 
45 0 0 0 0 0 0 0 52 0 0 0 8 0 0 0 0 0 0 43 
45 0 0 0 0 0 0 0 0 0 0 0 0 0 0 0 0 0 9 44 
45 0 0 0 0 0 0 0 0 0 0 0 0 0 0 0 0 0 0 43 
45 0 0 0 0 0 0 0 0 0 0 0 0 0 0 0 0 0 0 43 
45 0 0 0 0 0 0 0 0 0 0 0 0 0 0 0 0 0 0 43 
45 0 0 0 0 0 0 0 0 0 0 0 0 0 0 36 38 0 0 43 
45 0 0 0 0 0 0 0 0 0 0 0 0 0 0 43 18 0 0 43 
45 0 0 0 0 0 0 0 0 0 0 0 0 0 0 50 52 0 0 43 
45 0 0 0 0 0 0 0 0 0 0 0 0 0 0 0 0 0 0 43 
45 0 0 0 0 0 0 0 0 0 0 36 38 0 0 0 0 0 0 43 
45 0 0 0 0 0 0 0 0 0 0 43 18 0 0 0 0 0 0 43 
45 0 0 0 0 0 0 0 0 0 0 50 52 0 0 0 0 0 0 43 
45 0 0 0 0 0 0 0 0 0 0 0 0 0 0 0 0 0 0 43 
45 0 0 0 0 0 0 0 0 0 0 0 0 0 0 0 0 0 0 43 
45 0 0 0 0 0 0 0 0 0 0 0 0 0 0 0 0 0 0 43 
44 37 38 0 0 0 0 0 0 0 0 0 0 0 0 0 0 0 0 43 
44 51 51 10 11 0 0 0 0 0 0 0 0 0 0 8 0 0 0 43 
45 0 0 0 0 0 0 0 0 0 0 0 0 0 0 0 0 0 0 43 
45 0 0 0 0 0 0 0 0 0 0 0 0 0 0 0 0 0 0 43 
45 0 0 0 0 0 0 0 0 0 0 0 0 0 0 0 0 0 0 43 
45 0 0 0 0 0 0 0 0 9 10 11 0 0 0 0 0 0 0 18 
45 0 0 0 0 0 0 0 0 0 0 0 0 0 0 0 0 0 0 43 
45 0 0 0 0 0 0 0 0 0 0 0 0 0 0 0 0 0 0 43 
45 0 0 0 0 0 0 0 0 0 0 0 0 0 0 0 0 0 0 43 
45 0 0 0 0 0 0 0 0 0 0 0 0 0 0 0 0 0 0 43 
45 18 0 0 0 0 0 0 0 0 0 0 0 0 0 0 0 0 0 43 
44 38 0 0 0 0 0 0 0 0 0 0 0 0 0 0 0 0 0 43 
44 51 10 11 0 0 0 0 0 0 0 36 38 0 0 0 0 0 0 43 
45 0 0 0 0 0 0 0 0 0 0 43 44 38 0 0 0 0 0 43 
45 0 0 0 0 0 0 0 0 0 0 50 44 45 0 0 0 0 0 43 
45 0 0 0 0 0 0 0 0 0 0 0 50 51 11 0 0 0 0 43 
45 0 0 0 0 0 0 0 0 0 0 0 0 0 0 0 0 0 0 43 
45 0 0 0 0 0 0 0 0 0 0 0 0 0 0 0 0 0 0 43 
45 0 0 0 0 0 0 0 0 0 0 0 0 0 0 0 0 0 0 43 
45 0 0 0 0 0 0 0 0 0 0 0 0 0 0 0 0 0 0 18 
45 0 0 0 0 0 0 0 0 0 0 0 0 0 0 0 0 0 0 43 
45 0 0 0 0 0 0 0 0 0 0 36 0 0 0 0 0 0 0 43 
44 37 38 0 0 0 0 0 0 0 36 45 0 0 0 0 0 0 0 43 
44 44 45 0 0 0 0 0 0 0 43 45 0 0 0 0 0 0 0 43 
44 44 44 38 0 0 0 0 0 36 44 52 0 0 0 0 0 0 0 43 
44 51 51 52 18 0 0 0 18 50 52 0 0 0 0 0 0 0 0 43 
45 0 0 0 0 0 0 0 0 0 0 0 0 0 0 0 0 0 0 43 
45 0 0 0 0 0 0 0 0 0 0 0 0 0 0 0 0 0 0 43 
45 0 0 0 0 0 0 0 0 0 0 0 0 0 0 0 0 0 0 43 
45 0 0 0 0 0 0 0 0 0 0 0 0 0 0 0 0 0 0 43 
45 0 0 0 0 0 0 0 0 0 0 0 0 0 0 0 0 0 0 43 
45 0 0 0 0 0 0 0 0 0 0 0 0 0 0 0 0 0 0 43 
45 0 0 0 0 0 0 0 0 0 0 0 0 0 0 0 0 0 0 43 
45 0 8 0 0 0 0 0 0 0 8 0 0 0 0 0 0 0 0 43 
45 0 0 0 0 0 0 0 0 0 0 0 0 0 0 0 0 0 0 43 
45 0 0 0 0 0 0 0 0 0 0 0 0 0 0 0 0 0 18 43 
45 0 0 0 0 0 0 0 0 0 0 0 0 0 0 0 0 0 36 44 
45 0 0 0 0 0 0 0 0 0 0 0 0 0 0 0 0 0 43 44 
45 0 0 0 0 0 0 0 0 0 0 0 0 0 0 0 36 37 44 44 
45 0 0 0 0 0 8 0 0 0 0 0 0 0 0 0 50 51 51 44 
45 0 0 0 0 0 0 0 0 0 0 0 0 0 0 0 0 0 0 43 
45 0 0 0 0 0 0 0 0 0 0 0 0 0 0 0 0 0 0 43 
44 38 0 0 0 0 0 0 0 0 0 0 0 0 0 0 0 0 0 43 
44 51 11 0 0 0 0 0 0 0 0 0 0 0 0 0 0 0 0 43 
45 0 0 0 0 0 8 0 0 0 0 0 0 0 0 8 0 0 0 43 
45 0 0 0 0 0 0 0 0 0 0 0 0 0 0 0 0 0 0 43 
45 0 0 0 0 0 0 0 0 0 0 0 0 0 0 0 0 0 0 43 
45 0 0 0 0 0 0 0 0 0 0 0 0 0 0 0 0 0 0 43 
45 0 0 0 0 0 0 0 0 0 0 0 0 0 0 0 0 0 0 43 
45 0 0 0 0 0 0 0 0 0 0 0 0 0 0 0 0 0 0 18 
45 0 0 0 0 0 0 0 0 0 0 0 0 0 0 0 0 0 0 43 
45 0 0 0 0 0 0 0 0 0 0 0 0 0 0 0 0 0 0 43 
45 0 0 0 0 0 0 0 0 0 0 0 0 0 0 0 0 0 0 43 
45 0 0 0 0 0 0 0 0 0 0 36 0 0 0 0 0 0 0 43 
45 0 0 0 0 0 0 0 0 0 36 44 10 11 0 0 0 0 0 18 
45 0 0 0 0 0 0 0 0 18 43 45 0 0 0 0 0 0 0 43 
45 0 0 0 0 0 0 0 0 9 51 52 0 0 0 0 0 0 0 43 
45 0 0 0 0 0 0 0 0 0 0 0 0 0 0 0 0 0 0 43 
45 0 0 0 0 0 0 0 0 0 0 0 0 0 0 0 0 0 0 43 
45 0 0 0 0 0 0 0 0 0 0 0 0 0 0 0 0 0 0 43 
45 0 0 0 8 0 0 0 0 0 0 0 0 9 10 11 0 0 0 43 
45 0 0 0 0 0 0 0 0 0 0 0 0 0 0 0 0 0 0 43 
45 0 0 0 0 0 0 0 0 0 0 0 0 0 0 0 0 0 0 43 
45 0 0 0 0 0 0 0 0 0 0 0 0 0 0 0 0 0 0 43 
45 0 0 0 0 0 0 0 0 0 0 0 0 0 0 0 0 0 18 43 
45 0 0 0 0 0 0 0 0 0 0 0 0 0 0 0 0 0 36 44 
45 0 0 0 0 0 0 0 0 0 0 0 0 0 0 0 0 36 44 44 
45 0 0 0 0 0 0 0 0 0 0 0 0 0 0 0 9 51 51 44 
45 0 0 0 0 0 0 0 0 36 37 10 11 0 0 0 0 0 0 43 
45 0 0 0 0 0 0 9 10 51 52 0 0 0 0 0 0 0 0 43 
45 0 0 0 0 0 0 0 0 0 0 0 0 0 0 0 0 0 0 43 
45 0 0 0 0 0 0 0 0 0 0 0 0 0 0 0 0 0 0 43 
45 0 0 0 0 0 0 0 0 0 0 0 0 0 0 0 0 0 0 43 
45 0 0 0 0 0 0 0 0 0 0 0 0 0 0 0 0 0 0 43 
45 18 0 0 0 0 0 0 0 0 0 0 0 0 0 0 0 0 0 43 
44 38 0 0 0 0 0 0 0 0 0 0 0 0 0 0 0 0 0 43 
44 51 10 11 0 0 0 0 0 0 0 0 0 0 0 0 0 0 0 43 
45 0 0 0 0 0 0 0 0 0 0 0 0 0 0 0 0 0 0 43 
45 0 0 0 0 0 0 0 0 0 0 0 0 0 0 0 0 0 0 43 
45 0 0 0 0 0 0 0 0 0 0 0 0 0 0 0 0 0 0 43 
45 0 0 0 0 0 0 0 0 0 0 0 0 0 0 0 0 0 0 43 
45 0 0 0 0 0 0 0 0 0 0 0 0 0 0 0 0 0 18 43 
45 0 0 0 0 0 0 0 0 0 0 0 0 0 0 0 0 0 36 43 
45 0 0 0 0 36 38 0 0 0 0 0 0 0 0 0 9 37 44 43 
45 0 0 0 0 43 44 11 0 0 0 0 0 0 0 0 0 50 44 43 
45 0 0 0 36 44 45 0 0 0 0 0 0 0 0 0 0 0 50 43 
45 0 0 0 43 44 52 0 0 0 0 0 0 0 0 0 0 0 0 43 
45 0 0 9 44 45 0 0 0 0 0 0 0 0 0 0 0 0 0 43 
45 0 0 0 50 52 0 0 0 0 0 0 0 0 0 0 0 0 0 43 
45 0 0 0 0 0 0 0 0 0 0 0 0 0 0 0 0 0 0 43 
45 0 0 0 0 0 0 0 36 0 0 0 0 0 0 0 0 0 0 43 
45 0 0 0 0 0 0 0 43 38 0 0 0 0 0 0 0 0 0 43 
45 18 0 0 0 0 0 0 43 45 0 0 0 0 0 0 0 0 0 43 
44 10 11 0 0 0 0 0 43 45 0 0 0 0 0 0 0 0 0 43 
45 0 0 0 0 0 36 37 44 45 0 0 0 0 0 0 0 0 0 43 
45 0 0 0 0 0 50 51 44 44 37 38 0 0 0 0 0 0 0 43 
45 0 0 0 0 0 0 0 50 51 51 52 0 0 0 0 0 0 0 43 
45 0 0 0 0 0 0 0 0 0 0 0 0 0 0 0 0 0 0 43 
45 0 0 0 0 0 0 0 0 0 0 0 0 0 0 0 0 0 0 43 
45 0 0 0 0 0 0 0 0 0 0 0 0 0 0 0 0 0 0 18 
45 0 0 0 0 0 0 0 0 0 0 0 0 0 0 0 0 0 0 43 
45 0 0 0 0 0 0 0 0 0 0 0 0 0 0 0 0 0 0 43 
45 0 0 0 0 0 0 0 0 0 0 0 0 0 0 0 0 0 0 43 
45 0 0 0 0 0 0 0 0 0 0 0 0 0 0 0 0 0 0 43 
45 0 0 0 0 0 0 0 0 0 0 0 0 0 0 0 0 0 0 43 
45 0 0 0 0 0 0 0 0 0 0 0 0 0 0 0 0 0 0 43 
45 0 0 0 0 0 0 0 0 0 0 0 0 0 0 0 0 0 0 43 
45 0 0 0 0 0 0 0 0 0 0 0 0 0 0 0 0 0 18 43 
45 0 0 0 8 0 0 0 0 8 0 0 0 0 8 0 0 0 9 43 
45 0 0 0 0 0 0 0 0 0 0 0 0 0 0 0 0 0 0 43 
45 0 0 0 0 0 0 0 0 0 0 0 0 0 0 0 0 0 0 43 
45 0 0 0 0 0 0 0 0 0 0 0 0 0 0 0 0 0 0 43 
45 18 0 0 0 0 0 0 0 0 0 0 0 0 0 0 0 0 0 43 
45 38 0 0 0 0 0 0 0 0 0 0 0 0 0 0 0 0 0 43 
44 44 38 0 0 0 0 0 0 0 0 0 0 0 0 0 0 0 0 43 
44 51 52 0 0 0 0 0 0 0 0 0 0 0 0 0 0 0 0 43 
45 0 0 0 0 0 0 0 0 0 0 0 0 0 0 0 0 0 0 43 
45 0 0 0 0 0 0 0 0 0 0 0 0 0 0 0 0 0 0 43 
45 0 0 0 0 0 0 0 0 0 0 0 0 0 0 0 0 0 0 43 
45 0 0 0 0 0 0 0 0 0 0 0 0 0 0 0 0 0 0 43 
45 0 0 0 0 0 0 0 0 0 0 0 0 0 0 0 0 0 0 43 
45 18 0 0 0 0 0 0 0 0 0 0 0 0 0 0 0 0 0 43 
44 38 0 0 0 0 0 0 0 0 0 0 0 0 0 0 0 0 0 43 
44 51 10 10 11 0 0 0 0 0 0 0 0 0 0 0 0 0 0 43 
45 0 0 0 0 0 0 0 36 38 0 0 0 0 0 0 0 0 0 43 
45 0 0 0 0 0 0 0 50 52 0 0 0 0 0 0 0 0 0 43 
45 0 0 0 0 0 0 0 0 0 0 0 0 0 0 0 0 0 0 43 
45 0 0 0 0 0 0 0 0 0 0 0 0 0 0 0 0 0 0 43 
45 0 0 0 0 0 0 0 0 0 0 0 0 0 0 0 0 0 0 50 
45 0 0 0 0 0 0 0 0 0 0 0 0 0 0 0 0 0 0 18 
45 0 0 0 0 0 0 0 0 0 0 0 0 0 0 0 0 0 0 36 
45 0 0 0 0 0 0 0 36 37 38 0 0 0 0 0 0 0 9 44 
45 0 0 0 0 0 0 0 50 51 52 0 0 0 0 0 0 0 0 43 
45 0 0 0 0 0 0 0 0 0 0 0 0 0 0 0 0 0 0 43 
45 0 0 0 0 0 0 0 0 0 0 0 0 0 0 0 0 0 0 43 
45 0 0 0 0 0 0 0 0 0 0 0 0 0 0 0 0 0 0 43 
45 18 0 0 0 0 0 0 0 0 0 0 0 0 0 0 0 0 0 43 
44 38 0 0 0 0 0 0 0 0 0 0 0 0 0 0 0 0 0 43 
44 44 37 38 0 0 0 0 0 0 0 0 0 0 0 0 0 0 0 43 
44 51 51 52 0 0 0 0 0 0 0 0 0 0 0 0 0 0 0 43 
45 0 0 0 0 0 0 0 0 0 0 0 0 0 0 0 0 0 0 43 
45 0 0 0 0 0 0 0 0 0 36 37 37 38 0 0 0 0 0 43 
45 0 0 0 0 0 0 0 0 0 43 44 44 45 0 0 0 0 0 43 
45 0 0 0 0 0 0 0 0 0 43 44 44 45 18 0 0 0 0 43 
45 0 0 0 0 0 0 0 0 0 43 44 44 44 38 0 0 0 0 43 
45 0 0 0 0 0 0 0 0 0 43 44 44 51 51 11 0 0 0 43 
45 0 0 0 0 0 0 0 0 0 50 51 52 0 0 0 0 0 0 43 
45 0 0 0 0 0 0 0 0 0 0 0 0 0 0 0 0 0 36 44 
45 0 0 0 0 0 0 0 0 0 0 0 0 0 0 0 0 36 44 44 
45 0 0 0 0 0 0 0 0 0 36 37 38 0 0 0 0 43 44 44 
45 0 0 0 0 0 36 38 0 0 43 44 45 0 0 0 0 50 51 44 
45 0 0 0 0 0 50 52 0 0 43 44 45 0 0 0 0 0 0 43 
44 37 37 38 0 0 0 0 0 0 50 51 52 0 0 0 0 0 0 43 
44 44 44 45 0 0 0 0 0 0 0 0 0 0 0 0 0 0 0 43 
44 44 44 44 38 0 0 0 0 0 0 0 0 0 0 0 0 0 0 43 
44 44 44 44 44 37 37 37 37 37 37 37 37 37 37 37 37 37 37 44 
44 44 44 44 44 44 44 44 44 44 44 44 44 44 44 44 44 44 44 44 
44 44 44 44 44 44 44 44 44 44 44 44 44 44 44 44 44 44 44 44